{
  "width": 4,
  "height": 4,
  "depth": 4,
  "orbTiles": [
    { "i": 0, "j": 3, "k": 3 },
    { "i": 1, "j": 3, "k": 4 },
    { "i": 1, "j": 4, "k": 1 },
    { "i": 3, "j": 0, "k": 3 },
    { "i": 3, "j": 1, "k": 0 },
    { "i": 3, "j": 3, "k": 0 },
    { "i": 4, "j": 3, "k": 3 }
  ],
  "tileBlocks": [
    { "i": 0, "j": 1, "k": 1 },
    { "i": 1, "j": 0, "k": 1 },
    { "i": 1, "j": 1, "k": 4 },
    { "i": 1, "j": 3, "k": 0 },
    { "i": 3, "j": 0, "k": 1 },
    { "i": 3, "j": 1, "k": 4 },
    { "i": 3, "j": 4, "k": 3 }
  ],
  "edgeBlocks": [],
  "lightnings": [
    { "i": 0, "j": 0, "k": 3 },
    { "i": 0, "j": 3, "k": 2 },
    { "i": 0, "j": 3, "k": 4 },
    { "i": 1, "j": 4, "k": 2 },
    { "i": 1, "j": 4, "k": 4 },
    { "i": 2, "j": 3, "k": 4 },
    { "i": 3, "j": 2, "k": 0 },
    { "i": 3, "j": 4, "k": 0 },
    { "i": 4, "j": 1, "k": 2 },
    { "i": 4, "j": 2, "k": 1 },
    { "i": 4, "j": 2, "k": 3 },
    { "i": 4, "j": 3, "k": 0 },
    { "i": 4, "j": 4, "k": 1 }
  ]
}
